ACC = "countries/Archavon's Charge.txt"
AER = "countries/Aerie Peak.txt"
AHQ = "countries/Ahn'Qiraj.txt"
AGL = "countries/The Anglers.txt"
AKT = "countries/Amaki Tribe.txt"
ALT = "countries/Alterac.txt"
AMA = "countries/Amani Tribe.txt"
AME = "countries/Ameth'aran Ghosts.txt"
AML = "countries/Azuremyst Lashers.txt"
ANG = "countries/Angorosh Clan.txt"
ARD = "countries/Argent Dawn.txt"
ARK = "countries/Arkkoran.txt"
ASG = "countries/Azsuna Sea Giants.txt"
AUC = "countries/Auchenai.txt"
AXS = "countries/Axxarien Satyrs.txt"
AZB = "countries/Azurewing Brood.txt"
AZJ = "countries/Azjol-Nerub.txt"
AZS = "countries/Nazjatar Empire.txt"
BAM = "countries/Bael Modan.txt"
BBC = "countries/Burning Blade Clan.txt"
BCC = "countries/Bonechewer Clan.txt"
BDF = "countries/Blue Dragonflight.txt"
BDT = "countries/Bloodfury Tribe.txt"
BDS = "countries/Bladescale Tribe.txt"
BFC = "countries/Boulderfist Clan.txt"
BFE = "countries/Bloodfeather Tribe.txt"
BFT = "countries/Bloodfin Tribe.txt"
BGT = "countries/Bluegill Tribe.txt"
BHC = "countries/Bleeding Hollow Clan.txt"
BHS = "countries/Bleakheart Sect.txt"
BHT = "countries/Bloodhoof Tribe.txt"
BIL = "countries/Bilgewater Cartel.txt"
BKT = "countries/Broketooth Tribe.txt"
BLA = "countries/Blackfathom Tribe.txt"
BLC = "countries/The Black Lotus.txt"
BLF = "countries/Black Dragonflight.txt"
BLO = "countries/Bloodscalp Tribe.txt"
BLP = "countries/Bloodpaw Tribe.txt"
BLS = "countries/Blacksilt Tribe.txt"
BLT = "countries/Bristlelimb Tribe.txt"
BMC = "countries/Bloodmaul Clan.txt"
BML = "countries/Bloodmyst Lashers.txt"
BMT = "countries/Blackmaw Tribe.txt"
BON = "countries/Bonespeakers.txt"
BOO = "countries/Booty Bay.txt"
BPL = "countries/Bloodpetal Lashers.txt"
BPT = "countries/Bloodspore Tribe.txt"
BRC = "countries/Blackrock Clan.txt"
BRF = "countries/Bronze Dragonflight.txt"
BRI = "countries/Bristleback Tribe.txt"
BRK = "countries/The Broken.txt"
BRM = "countries/Brineclaw Makrura.txt"
BRS = "countries/Bonetrail Ranishu.txt"
BSB = "countries/Bloodsail Bucanners.txt"
BSC = "countries/Bladespire Clan.txt"
BST = "countries/Barkskin Tribe.txt"
BTG = "countries/Black Tooth Grin Clan.txt"
BTM = "countries/Bittertide Makrura.txt"
BTR = "countries/Bloodtooth Tribe.txt"
BTT = "countries/Bloodtotem Tribe.txt"
BWC = "countries/Bladewind Clan.txt"
BWK = "countries/Bluewax Tribe.txt"
BWT = "countries/Blackwood Tribe.txt"
CAB = "countries/Cabal.txt"
CAE = "countries/Caer Darrow.txt"
CDS = "countries/Cult of the Dark Strand.txt"
CEN = "countries/Cenarion Circle.txt"
CLO = "countries/Challiane's Orchard.txt"
CMT = "countries/Chillmere Tribe.txt"
CNH = "countries/Cenarion Hold.txt"
CNT = "countries/Centipaar Silithid.txt"
COF = "countries/Court of Farondis.txt"
COH = "countries/Coldwind Harpys.txt"
CRC = "countries/Crushridge Clan.txt"
CRF = "countries/Crestfall.txt"
CRY = "countries/Crystal Vice Giants.txt"
CSS = "countries/Crystalsong Satyrs.txt"
CWT = "countries/Camp Winterhoof.txt"
DAL = "countries/Dalaran.txt"
DAR = "countries/Dun Argol.txt"
DRA = "countries/Drakkari.txt"
DBC = "countries/Dustbelcher Clan.txt"
DDT = "countries/The Deadtalkers.txt"
DDW = "countries/Deadwood Tribe.txt"
DEV = "countries/The Devoted.txt"
DFB = "countries/Defias Brotherhood.txt"
DFC = "countries/Dragonflayer Clan.txt"
DFT = "countries/Darkfin Tribe.txt"
DGT = "countries/Daggerspine Tribe.txt"
DHT = "countries/Darkhatched Tribe.txt"
DHY = "countries/Darrow Hill Yetis.txt"
DIC = "countries/Darkiron Clan.txt"
DKG = "countries/Da'kani Gorillas.txt"
DMC = "countries/Dragonmaw Clan.txt"
DMG = "countries/Darkmist Ghosts.txt"
DMW = "countries/Dun Morogh Wendigo.txt"
DOA = "countries/Disciples of Akunda.txt"
DOC = "countries/Disciples of Chi-Ji.txt"
DON = "countries/Disciples of Niuzao.txt"
DOJ = "countries/Dojani Clan.txt"
DOX = "countries/Disciples of Xuen.txt"
DOY = "countries/Disciples of Yu'lon.txt"
DRE = "countries/Draenei Exiles.txt"
DRK = "countries/Drekirjar.txt"
DRM = "countries/Dreadmaul Clan.txt"
DRT = "countries/The Deadrot.txt"
DRW = "countries/The Dreamweavers.txt"
DRY = "countries/Drysnap Tribe.txt"
DSG = "countries/Deep Strider Giants.txt"
DSK = "countries/Darkshire.txt"
DSM = "countries/Darkshore Moonkin.txt"
DST = "countries/Darkspear Tribe.txt"
DTR = "countries/Dethryll Sect.txt"
DUC = "countries/Dunemaul Clan.txt"
DUN = "countries/Dun Modr.txt"
DUR = "countries/Durnholde.txt"
DWC = "countries/Deadwind Clan.txt"
DWK = "countries/Drywhisker Kobold.txt"
DWN = "countries/Dawnstrider Tribe.txt"
DWT = "countries/Dustwind Tribe.txt"
EAG = "countries/Eaglehorn Tribe.txt"
ELD = "countries/Eldre'thar.txt"
ELK = "countries/Elwynn Kobolds.txt"
ELM = "countries/Elwynn Murlocs.txt"
ELW = "countries/Elwynn.txt"
EVR = "countries/Everlook.txt"
FAL = "countries/The Fal'Dorei.txt"
FAN = "countries/The Fallen.txt"
FAR = "countries/Farraki Tribe.txt"
FDW = "countries/Fen Dwellers.txt"
FFT = "countries/Frostfeather Tribe.txt"
FGC = "countries/Firegut Clan.txt"
FGH = "countries/Fieldgiant Silithid.txt"
FHT = "countries/Frenzyheart Tribe.txt"
FLE = "countries/The Faithless Empire.txt"
FMC = "countries/Felmusk Clan.txt"
FMG = "countries/Frostmaul Giants.txt"
FRB = "countries/The Frostborn.txt"
FRG = "countries/Fel Rock Grell.txt"
FRT = "countries/Frostmane Tribe.txt"
FSA = "countries/Fallow Sanctuary.txt"
FSK = "countries/The Forsaken.txt"
FST = "countries/Fallsong Tribe.txt"
FSY = "countries/Feral Scar Yetis.txt"
FTT = "countries/Firetree Tribe.txt"
FWC = "countries/Frostwolf Clan.txt"
FWT = "countries/Foulweald Tribe.txt"
GAL = "countries/Galak Tribe.txt"
GAD = "countries/Gadgetzan.txt"
GAR = "countries/Garadar.txt"
GCT = "countries/Gai-cho Tribe.txt"
GDD = "countries/GDF Dream Bough.txt"
GDF = "countries/Green Dragonflight.txt"
GDS = "countries/GDF Bough Shadow.txt"
GFT = "countries/Goldfin Tribe.txt"
GHG = "countries/Grizzly HillS Giants.txt"
GHS = "countries/Gjalerhorn Snobolds.txt"
GIL = "countries/Gilneas.txt"
GLC = "countries/Gelkis Clan.txt"
GMT = "countries/Greymist Tribe.txt"
GNO = "countries/Gnomeregan.txt"
GOH = "countries/Guardians of Hyjal.txt"
GOI = "countries/Gorishi Silithid.txt"
GOM = "countries/Gormali Clan.txt"
GOR = "countries/Gordunni Clan.txt"
GPR = "countries/Gnarlpine Tribe.txt"
GRA = "countries/Gravelsnout Kobolds.txt"
GRM = "countries/Grimtotem Tribe.txt"
GRN = "countries/The Gronn.txt"
GRO = "countries/Grooking Tribe.txt"
GRU = "countries/The Grummles.txt"
GSR = "countries/GDF Seradane.txt"
GTG = "countries/GDF Temple of Hakkar.txt"
GTH = "countries/GDF Twilight Grove.txt"
GUR = "countries/Gurubashi Empire.txt"
GUT = "countries/Gurthani Ghosts.txt"
GZM = "countries/Grizzlemaw.txt"
HAK = "countries/Hakkari Trolls.txt"
HAS = "countries/Hive'Ashi.txt"
HAZ = "countries/Hazzali Silithid.txt"
HBG = "countries/The Harborage.txt"
HCT = "countries/Hatecrest Tribe.txt"
HDC = "countries/Haldarr Clan.txt"
HEA = "countries/Hearthglen.txt"
HEL = "countries/Helheim.txt"
HFS = "countries/Hatefury Sect.txt"
HIB = "countries/Hillsbrad.txt"
HIG = "countries/Highborne Ghosts.txt"
HIV = "countries/Highvale.txt"
HLS = "countries/Howling Sprites.txt"
HLT = "countries/Howling Tribe.txt"
HMT = "countries/Highmountain Tribe.txt"
HON = "countries/Honor Hold.txt"
HRE = "countries/Hive'Regal.txt"
HRG = "countries/The Hrothgar.txt"
HWT = "countries/Hawkwind Tribe.txt"
HYL = "countries/Hyldnir Clan.txt"
HZO = "countries/Hive'Zora.txt"
IDF = "countries/Infinite Dragonflight.txt"
ICM = "countries/Icemist Tribe.txt"
INK = "countries/Inkgill Tribe.txt"
IRO = "countries/Ironforge.txt"
ITY = "countries/Ice Thistle Yeti.txt"
JFT = "countries/Jadefire Tribe.txt"
JPT = "countries/Jaspertip Tribe.txt"
KAL = "countries/The Kaldorei.txt"
KAR = "countries/Karazhan.txt"
KLK = "countries/Kalu'ak.txt"
KLX = "countries/The Klaxxi.txt"
KOL = "countries/Kolkar Clan.txt"
KOR = "countries/Korjan Clan.txt"
KOU = "countries/Keepers of Ulduar.txt"
KRA = "countries/Krasari Clan.txt"
KRM = "countries/Kril'mandar Tribe.txt"
KRN = "countries/Korune Clan.txt"
KTG = "countries/Kel’theril Ghosts.txt"
KTT = "countries/Knucklethump Tribe.txt"
KUL = "countries/Kul'tiras.txt"
KVX = "countries/The Kel'vaxi.txt"
KZC = "countries/Kurzens Compound.txt"
KZT = "countries/Kunzen Tribe.txt"
LAP = "countries/Lapidis Tribe.txt"
LBC = "countries/Lightning's Blade Clan.txt"
LEG = "countries/Legashi Sect.txt"
LEP = "countries/Leper Gnomes.txt"
LOA = "countries/League of Arathor.txt"
LOR = "countries/Lordaeron.txt"
LSC = "countries/Laughing Skull Clan.txt"
MAK = "countries/Makrinni Tribe.txt"
MAN = "countries/Mantid Empire.txt"
MAU = "countries/Mauradon.txt"
MBT = "countries/Mistblade Tribe.txt"
MCG = "countries/Mechagon.txt"
MCT = "countries/Muckscale Tribe.txt"
MDC = "countries/Mjordin Clan.txt"
MFT = "countries/Mossflayer Tribe.txt"
MGC = "countries/Magram Clan.txt"
MGE = "countries/Mogu Empire.txt"
MGJ = "countries/Mogujia Clan.txt"
MGS = "countries/Mogu'shan Vaults.txt"
MGT = "countries/Murkgill Tribe.txt"
MHT = "countries/Mosshide Tribe.txt"
MIR = "countries/Mirefin Tribe.txt"
MKR = "countries/Mak'rana.txt"
MKT = "countries/Muckshell Tribe.txt"
MLC = "countries/Molten Core.txt"
MMH = "countries/Magmoth Herd.txt"
MNT = "countries/Moontouched Tribe.txt"
MOC = "countries/MoshOgg Clan.txt"
MOG = "countries/Mogrosh Clan.txt"
MOK = "countries/Mok'Nathal.txt"
MOO = "countries/The Moonguard.txt"
MRP = "countries/Moonrage Pack.txt"
MST = "countries/Mudsnout Tribe.txt"
MTT = "countries/Marshtide Tribe.txt"
MWA = "countries/Mosswalker Tribe.txt"
MWH = "countries/Mistwhisper Tribe.txt"
MWT = "countries/Moonwing Tribe.txt"
MZT = "countries/Maz’Thoril.txt"
NAE = "countries/Naga Explorers.txt"
NBP = "countries/Nightbane Pack.txt"
NDF = "countries/Nightmare Dragonflight.txt"
NDG = "countries/Nor'Danil Ghosts.txt"
NDR = "countries/Needlerock Tribe.txt"
NEF = "countries/Neferset.txt"
NET = "countries/Nethergarde Keep.txt"
NRT = "countries/Northeron.txt"
NST = "countries/Northspring Tribe.txt"
NTS = "countries/Nettleskin Sprites.txt"
NVT = "countries/Natha'vor Tribe.txt"
NWT = "countries/Nestlewood Tribe.txt"
NZM = "countries/Nazmani Tribe.txt"
NZS = "countries/Nazzivus Satyrs.txt"
ODT = "countries/Ordon Tribe.txt"
OGL = "countries/Ogri'la.txt"
OGR = "countries/Ogrimmar.txt"
OLT = "countries/Osul Tribe.txt"
ONY = "countries/Onyxias Brood.txt"
OOK = "countries/Ookin Tribe.txt"
OOM = "countries/Oomlot Tribe.txt"
OON = "countries/Oona Tribe.txt"
ORD = "countries/Ordo Tribe.txt"
OQW = "countries/Oneqwah Tribe.txt"
ORS = "countries/Orsis.txt"
OWT = "countries/Owlwing Tribe.txt"
PAL = "countries/Palemane Tribe.txt"
PBT = "countries/Paleblade Tribe.txt"
PFJ = "countries/Pearlfin Jinyu.txt"
PIG = "countries/Purgation Isle Ghosts.txt"
PJG = "countries/Pi'jiu Ghosts.txt"
POE = "countries/Protectors of the Endless.txt"
PWT = "countries/Palewind Tribe.txt"
QLL = "countries/Quel'lithien Lodge.txt"
QUE = "countries/Quel'Thalas.txt"
RAT = "countries/Ratchet.txt"
RBG = "countries/Rockbiter Giants.txt"
RBT = "countries/Riverblade Tribe.txt"
RCP = "countries/Rockpool Tribe.txt"
RDF = "countries/Red Dragonflight.txt"
RDR = "countries/Redridge.txt"
RFT = "countries/Ragefeather Tribe.txt"
RGC = "countries/Rageclaw Tribe.txt"
RHP = "countries/Rot Hide Pack.txt"
RHU = "countries/Ravenhill Undeads.txt"
RIV = "countries/Rivermane Tribe.txt"
RJT = "countries/Rockjaw Tribe.txt"
RKH = "countries/Ramkahen.txt"
RKS = "countries/Rikkitun Sprites.txt"
RMH = "countries/Rustmaul Silithid.txt"
ROC = "countries/Rockaway Tribe.txt"
ROJ = "countries/Realm of Jade.txt"
RPP = "countries/Riverpaw Pack.txt"
RPT = "countries/Redpine Tribe.txt"
RRM = "countries/Redridge Murlocs.txt"
RRP = "countries/Redridge Pack.txt"
RST = "countries/Rainspeaker Tribe.txt"
RSY = "countries/Rage Scar Yetis.txt"
RTT = "countries/Raventusk Tribe.txt"
RWC = "countries/Redwalker Clan.txt"
RZB = "countries/Razormaws Brood.txt"
RZF = "countries/Razorfen Tribe.txt"
RZM = "countries/Razormane Tribe.txt"
RZT = "countries/Razor Talon Tribe.txt"
SAL = "countries/Salteye Tribe.txt"
SAT = "countries/Saltspittle Tribe.txt"
SBC = "countries/Snowblind Clan.txt"
SBT = "countries/Slitherblade Tribe.txt"
SCC = "countries/Scarlet Crusade.txt"
SCR = "countries/Screeching Tribe.txt"
SDT = "countries/Stonedark Tribe.txt"
SET = "countries/Sethekk.txt"
SFB = "countries/Southsea Free Booters.txt"
SFC = "countries/Splinterfist Clan.txt"
SFT = "countries/Stonefin Tribe.txt"
SGT = "countries/Slingtail Tribe.txt"
SHA = "countries/Shadowhide Clan.txt"
SHC = "countries/Shattered Hand Clan.txt"
SHD = "countries/Shen'Dralar.txt"
SHO = "countries/Shoalfin Tribe.txt"
SHP = "countries/The Shado-pan.txt"
SHR = "countries/Stonehearth.txt"
SHT = "countries/Shadethicket.txt"
SIL = "countries/Siltfin Tribe.txt"
SKA = "countries/The Skadir.txt"
SKB = "countries/Skumblade Tribe.txt"
SKE = "countries/Skettis.txt"
SKT = "countries/Sparktouched Tribe.txt"
SKU = "countries/Skullsplitter Tribe.txt"
SKW = "countries/Skywall.txt"
SKY = "countries/Skyhorn Tribe.txt"
SLI = "countries/Slitherscale Tribe.txt"
SLP = "countries/Solstice Trappers.txt"
SLT = "countries/Spitelash Tribe.txt"
SLW = "countries/Sholazar Watchers.txt"
SMC = "countries/Shadowmoon Clan.txt"
SMT = "countries/Smolderhide Tribe.txt"
SMR = "countries/Smolderthorn Tribe.txt"
SNT = "countries/Snowplain Tribe.txt"
SOH = "countries/Son of Hodir.txt"
SOP = "countries/Stonespire Tribe.txt"
SPC = "countries/Stormpike Clan.txt"
SPH = "countries/Spirithorn Tribe.txt"
SPR = "countries/Sumprush Lurkers.txt"
SPT = "countries/Shadowpine Tribe.txt"
SPY = "countries/Sand Pygmy.txt"
SQT = "countries/Squallfin Tribe.txt"
SRC = "countries/Stormreaver Clan.txt"
SRD = "countries/Storm Dragons.txt"
SRG = "countries/The Scourge.txt"
SSC = "countries/Shadowsworn Cultists.txt"
SSE = "countries/Sandstorm Elementals.txt"
SSG = "countries/Stranglethorn Sea Giants.txt"
SSH = "countries/Strashaz Tribe.txt"
SSM = "countries/Slimeshell Makrura.txt"
SSP = "countries/Stonesplinter Tribe.txt"
SST = "countries/Stormscale Tribe.txt"
STB = "countries/Snagtooth Brood.txt"
STC = "countries/Steamwheedle Cartel.txt"
STF = "countries/Stone Dragonflight.txt"
STH = "countries/Stratholme.txt"
STM = "countries/Stonemaul Clan.txt"
STN = "countries/Shao-tien Clan.txt"
STO = "countries/Stormwind.txt"
STP = "countries/Stillpine Tribe.txt"
STR = "countries/Stromgarde.txt"
STS = "countries/Shatterspear Tribe.txt"
STT = "countries/Shadowtooth Tribe.txt"
STV = "countries/Springtail Virmen.txt"
SUR = "countries/Suramar.txt"
SVB = "countries/Silverbrook.txt"
SVH = "countries/Savage Hill Tribe.txt"
SVT = "countries/Stonevault Troggs.txt"
SWA = "countries/Swamprock Tribe.txt"
SWT = "countries/Snowfall Tribe.txt"
SYN = "countries/Syndicate.txt"
SZC = "countries/Shan'ze Clan.txt"
TAG = "countries/Tel'Abim Gorillas.txt"
TAR = "countries/Tar Beasts.txt"
TBL = "countries/The Burning Legion.txt"
TDC = "countries/The Dark Conclave.txt"
TDF = "countries/Tideflat Tribe.txt"
TFT = "countries/Torn Fin Tribe.txt"
TGD = "countries/Twisted Glade Dryads.txt"
TGL = "countries/The Golden Lotus.txt"
THB = "countries/Thunder Bluff.txt"
THC = "countries/Twilight's Hammer Clan.txt"
THI = "countries/Thistleshrub.txt"
THM = "countries/Thor Modan.txt"
THR = "countries/Thorium Brotherhood.txt"
THT = "countries/Thistlefur Tribe.txt"
THZ = "countries/Therazane.txt"
TID = "countries/Tideskorn.txt"
TIL = "countries/The Tillers.txt"
TIM = "countries/Timbermaw Tribe.txt"
TIN = "countries/Tinker's Union.txt"
TKT = "countries/Taunka'le Tribe.txt"
TLC = "countries/Thunderlord Clan.txt"
TLF = "countries/The Lost Fleet.txt"
TLO = "countries/The Lost.txt"
TLS = "countries/Thistleleaf Sprites.txt"
TLT = "countries/Taunkalo Tribe.txt"
TMB = "countries/Tomb Guardians.txt"
TMI = "countries/Theramore Isle.txt"
TML = "countries/Timberlings.txt"
TMT = "countries/Thunderhorn Tribe.txt"
TNS = "countries/Townlong Sprites.txt"
TOL = "countries/Tol'Barad.txt"
TRK = "countries/Tunnel Rat Kobolds.txt"
TSC = "countries/The Shadow Council.txt"
TSW = "countries/The Swampwalkers.txt"
TTT = "countries/Tortaka Tribe.txt"
TUB = "countries/The Unbound.txt"
TVC = "countries/The Venture Co.txt"
TWP = "countries/Terrowulf Pack.txt"
TWV = "countries/The Withervine.txt"
TYR = "countries/Tyr's Hand.txt"
UDA = "countries/Uldaman.txt"
UFE = "countries/Un'goro Fire Elementals.txt"
UGT = "countries/Unga Tribe.txt"
ULD = "countries/Uldum Watchers.txt"
ULT = "countries/Underlight Tribe.txt"
UND = "countries/Understone Tribe.txt"
UNG = "countries/Ungoro Watchers.txt"
VAK = "countries/Valkyra.txt"
VAL = "countries/Valarjar.txt"
VER = "countries/Verlok Tribe.txt"
VFT = "countries/Vile Fin Tribe.txt"
VIL = "countries/Vilebranch Tribe.txt"
VLK = "countries/Valkyrion Clan.txt"
VMR = "countries/Vermillion Redoubt.txt"
VOL = "countries/The Voldunai.txt"
WAR = "countries/The Watchers.txt"
WBT = "countries/Witherbark Tribe.txt"
WDS = "countries/Wildscale Tribe.txt"
WFM = "countries/Westfall Murlocs.txt"
WFT = "countries/Windfury Tribe.txt"
WIL = "countries/Wildmane Tribe.txt"
WIN = "countries/Winterhoof Tribe.txt"
WIT = "countries/The Withered.txt"
WMC = "countries/Warmaul Clan.txt"
WNT = "countries/Winterfall Tribe.txt"
WOR = "countries/Wormwing Tribe.txt"
WPT = "countries/Woodpaw Tribe.txt"
WRT = "countries/Winterax Tribe.txt"
WSC = "countries/Warsong Clan.txt"
WSH = "countries/Windshear Tribe.txt"
WSS = "countries/Wildspawn Satyrs.txt"
WST = "countries/Westfall.txt"
WTF = "countries/Winterfin Tribe.txt"
WTS = "countries/Winter's Sisters.txt"
WWB = "countries/Wastewander Bandits.txt"
WWT = "countries/Witchwing Tribe.txt"
XAV = "countries/Xavian Sect.txt"
YGQ = "countries/Yongqi Tribe.txt"
YHC = "countries/Ymirheim Clan.txt"
YOG = "countries/Yogg-Saron.txt"
ZAN = "countries/Zandalari Tribe.txt"
ZAU = "countries/Zalazanes Uprising.txt"
ZLC = "countries/Zem'lan's Crew.txt"
ZLD = "countries/Zuldare.txt"
ZNE = "countries/Zandalari Exiles.txt"
ZNZ = "countries/The Zanzil.txt"
ZRK = "countries/Zak'rajan's Kingdom.txt"
ZUK = "countries/Zukk'ash Silithid.txt"
ZZD = "countries/Draenor.txt"
ZZO = "countries/Outland.txt"
ZZT = "countries/Teldrassil.txt"